...E#..........................................
....#..........................................
....#..........................................
....#..........................................
....#..........................................
....#..........................................
....###########################################
...............................................
.............................................G.
...............................................
....###########################################
....#..........................................
....#..........................................
....#..........................................
....#..........................................
....#..........................................
....#..........................................
....#..........................................
....#..........................................
....#..........................................
....#..........................................
....#..........................................
....#..........................................
....#..........................................
....#..........................................
....#..........................................
...E#..........................................